000000000000000000000000001000000000000000
000000000000000000000000001000000000000000
000000000000000000000000001000000000000000
111111111111111111111111111000000000000000
000000000000000000000000001000000000000000
000000000000000000001111001111110011111111
000000000000000000001001000010010010000000
000000333333333000001001000010010010000000
000000333333333000001001000010010010000000
000000333333333000001001000010010010000000
000000333333333000001001000010010010000000
000000333333333111111001000010010010000000
000000333333333000000001000010010010000000
000000333333333000000001000010010010000000
000000333333333000000001111110010010000000
000000333333333000000000000010010010000000
000000000000000000000000000010010010000000
000000000000000000000000000010010010000000
000000000000000000000000000010010010000000
000000000000000000000000000010011111111111
000000000000000000000000000010000000000000
000000000000000000000000000010000000000000
